Test Project Alpha v.1.0
An Interactive Fiction by Yim
Release 1 / Serial number 171116 / Inform 7 build 6M62 (I6/v6.33 lib 6/12N) SD

Center
Your vision blurred as you came to. Your memory is hazy and you can't remember the last time you were awake. You look around and find yourself in what looks like a beat-down motel room.

As you sit up, you can't help but notice that you were lying on a disgusting rug.

You notice a tape recorder next to you. Odd. Maybe you should switch it on and find out if there's anything useful on it?

>enter cabin
You can't see any such thing.

I beg your pardon?

>go in cabin
You can't see any such thing.

>look at cabin
You can't see any such thing.

* * *

Test Project Alpha v.1.0
An Interactive Fiction by Yim
Release 1 / Serial number 171116 / Inform 7 build 6M62 (I6/v6.33 lib 6/12N) SD

Center
Your vision blurred as you came to. Your memory is hazy and you can't remember the last time you were awake. You look around and find yourself in what looks like a beat-down motel room.

As you sit up, you can't help but notice that you were lying on a disgusting rug.

You notice a tape recorder next to you. Odd. Maybe you should switch it on and find out if there's anything useful on it?

>look for shelter
You can't see any such thing.

* * *

Test Project Alpha v.1.0
An Interactive Fiction by Yim
Release 1 / Serial number 171116 / Inform 7 build 6M62 (I6/v6.33 lib 6/12N) SD

Center
Your vision blurred as you came to. Your memory is hazy and you can't remember the last time you were awake. You look around and find yourself in what looks like a beat-down motel room.

As you sit up, you can't help but notice that you were lying on a disgusting rug.

You notice a tape recorder next to you. Odd. Maybe you should switch it on and find out if there's anything useful on it?

>Find shelter
That's not a verb I recognise.

>look shelter
You can't see any such thing.

>find shelter
That's not a verb I recognise.

>see shelter
That's not a verb I recognise.

>find cabin
That's not a verb I recognise.

* * *

Test Project Alpha v.1.0
An Interactive Fiction by Yim
Release 1 / Serial number 171116 / Inform 7 build 6M62 (I6/v6.33 lib 6/12N) SD

Center
Your vision blurred as you came to. Your memory is hazy and you can't remember the last time you were awake. You look around and find yourself in what looks like a beat-down motel room.

As you sit up, you can't help but notice that you were lying on a disgusting rug.

You notice a tape recorder next to you. Odd. Maybe you should switch it on and find out if there's anything useful on it?

>help
That's not a verb I recognise.

I beg your pardon?

* * *

Test Project Alpha v.1.0
An Interactive Fiction by Yim
Release 1 / Serial number 171116 / Inform 7 build 6M62 (I6/v6.33 lib 6/12N) SD

Center
Your vision blurred as you came to. Your memory is hazy and you can't remember the last time you were awake. You look around and find yourself in what looks like a beat-down motel room.

As you sit up, you can't help but notice that you were lying on a disgusting rug.

You notice a tape recorder next to you. Odd. Maybe you should switch it on and find out if there's anything useful on it?

>Grab torch
That's not a verb I recognise.

>Examine torch
You can't see any such thing.

>Examine room
You can't see any such thing.

>Look at room
You can't see any such thing.

* * *

Test Project Alpha v.1.0
An Interactive Fiction by Yim
Release 1 / Serial number 171116 / Inform 7 build 6M62 (I6/v6.33 lib 6/12N) SD

Center
Your vision blurred as you came to. Your memory is hazy and you can't remember the last time you were awake. You look around and find yourself in what looks like a beat-down motel room.

As you sit up, you can't help but notice that you were lying on a disgusting rug.

You notice a tape recorder next to you. Odd. Maybe you should switch it on and find out if there's anything useful on it?

>Grab backpack
That's not a verb I recognise.

* * *

Test Project Alpha v.1.0
An Interactive Fiction by Yim
Release 1 / Serial number 171116 / Inform 7 build 6M62 (I6/v6.33 lib 6/12N) SD

Center
Your vision blurred as you came to. Your memory is hazy and you can't remember the last time you were awake. You look around and find yourself in what looks like a beat-down motel room.

As you sit up, you can't help but notice that you were lying on a disgusting rug.

You notice a tape recorder next to you. Odd. Maybe you should switch it on and find out if there's anything useful on it?

>Take backpack
You can't see any such thing.

>Look
Dungeon
You wake up in a room with metallic walls a lamp above you.

>Table
That's not a verb I recognise.

>Examine room
You can't see any such thing.

>Examine
What do you want to examine?

>Dungeon
You can't see any such thing.

* * *

>Take backpack
You can't see any such thing.

>Grab backpack
That's not a verb I recognise.

>examine room
You can't see any such thing.

>examine table
You see nothing special about Wooden Table.

* * *

Test Project Alpha v.1.0
An Interactive Fiction by Yim
Release 1 / Serial number 171116 / Inform 7 build 6M62 (I6/v6.33 lib 6/12N) SD

Center
Your vision blurred as you came to. Your memory is hazy and you can't remember the last time you were awake. You look around and find yourself in what looks like a beat-down motel room.

As you sit up, you can't help but notice that you were lying on a disgusting rug.

You notice a tape recorder next to you. Odd. Maybe you should switch it on and find out if there's anything useful on it?

>Examine room.
You can't see any such thing.

>Examine room
You can't see any such thing.

>Examine Unknown Location
You can't see any such thing.

>Examine unknown location
You can't see any such thing.

>Look at room
You can't see any such thing.

>look at unknown room
You can't see any such thing.

>look at unknown location
You can't see any such thing.

* * *

Test Project Alpha v.1.0
An Interactive Fiction by Yim
Release 1 / Serial number 171116 / Inform 7 build 6M62 (I6/v6.33 lib 6/12N) SD

Center
Your vision blurred as you came to. Your memory is hazy and you can't remember the last time you were awake. You look around and find yourself in what looks like a beat-down motel room.

As you sit up, you can't help but notice that you were lying on a disgusting rug.

You notice a tape recorder next to you. Odd. Maybe you should switch it on and find out if there's anything useful on it?

>examine unknown location
You can't see any such thing.

* * *

Test Project Alpha v.1.0
An Interactive Fiction by Yim
Release 1 / Serial number 171116 / Inform 7 build 6M62 (I6/v6.33 lib 6/12N) SD

Center
Your vision blurred as you came to. Your memory is hazy and you can't remember the last time you were awake. You look around and find yourself in what looks like a beat-down motel room.

As you sit up, you can't help but notice that you were lying on a disgusting rug.

You notice a tape recorder next to you. Odd. Maybe you should switch it on and find out if there's anything useful on it?

>Take items
You can't see any such thing.

>Take things
Flashlight: Taken.
Knife: Taken.

>Take Backpack
Taken.

>Take flashlight
You already have that.

>Take backpack
You already have that.

>take knife
You already have that.

>Use flashlight
That's not a verb I recognise.

>Switch on flashlight
It isn't something you can switch.

>turn on flashlight
It isn't something you can switch.

* * *

Test Project Alpha v.1.0
An Interactive Fiction by Yim
Release 1 / Serial number 171116 / Inform 7 build 6M62 (I6/v6.33 lib 6/12N) SD

Center
Your vision blurred as you came to. Your memory is hazy and you can't remember the last time you were awake. You look around and find yourself in what looks like a beat-down motel room.

As you sit up, you can't help but notice that you were lying on a disgusting rug.

You notice a tape recorder next to you. Odd. Maybe you should switch it on and find out if there's anything useful on it?

>look at rug
A crusty, old, disgusting rug. Is there no decency for hygiene?

>look northwest
You see nothing unexpected in that direction.

>look at tape recorder
The tape recorder is currently switched off.

>switch on tape recorder
You switch the tape recorder on.

>look at tape recorder
The tape recorder is currently switched on.

>listen to tape recorder
You hear nothing unexpected.

>examine tape recorder
The tape recorder is currently switched on.

* * *

>look at rug
A crusty, old, disgusting rug. Is there no decency for hygiene?

>look at tape recorder
The tape recorder is currently switched off.

>switch tape recorder on
You switch the tape recorder on.

>listen to tape recorder
You hear nothing unexpected.

* * *

>look at tape recorder
The tape recorder is currently switched off.

>take recorder
Taken.

>turn on recorder
The tape plays and a heavily altered and ominous voice plays. "Hey, so you're not supposed to hear this, but you've been...abducted...to play this so-called "game" created by my father. I know, I know. It's pretty fucked up, you know, without your consent and whatnot. My dad is a...strange, maniacal man. He likes to toy with his prey before he kills them. Speaking of which, you need to get out of there as fast as you can. If you don't, you'll either be stuck there or die. Look around the room, search for clues, do anything necessary to leave this place! However, be careful with what you do. Committing certain actions without thinking about the consequences may jeopardize your chance of beating this game. Good luck." The tape ends.

You switch the tape recorder on.

>switch off recorder
You switch the tape recorder off.

* * *

>look at tape recorder
The tape recorder is currently switched off.

>look around room
You can't see any such thing.

>look around center
You can't see any such thing.

>look northwest
You see nothing unexpected in that direction.

* * *

>look at tape recorder
The tape recorder is currently switched off.

>play tape recorder
That's not a verb I recognise.

>turn on tape recorder
The tape plays and a heavily altered and ominous voice plays.
"Hey, so you're not supposed to hear this, but you've been...abducted...to play this so-called "game" created by my father. I know, I know. It's pretty fucked up, you know, without your consent and whatnot. My dad is a...strange, maniacal man. He likes to toy with his prey before he kills them. Speaking of which, you need to get out of there as fast as you can. If you don't, you'll either be stuck there or die. Look around the room, search for clues, do anything necessary to leave this place! However, be careful with what you do. Committing certain actions without thinking about the consequences may jeopardize your chance of beating this game. Good luck."
The tape ends.

You switch the tape recorder on.

>look around
You can't see any such thing.

>look northwest
You see nothing unexpected in that direction.

>go northwest
Kitchen
The Kitchen reeks of something putrid. You cannot make out what the smell is or where it is coming from.

You can see Sink, Countertop, Stove, Oven, Kitchen cabinets (closed) and Refrigerator (closed) here.

>look at fridge
It's a plain white refrigerator with red and brown splashes all over it. You have no idea what it is, but you don't want to catch something, do you?

>open fridge
You struggle to open the fridge door due to a gel-like substance outlining its edges. As you slowly pull the door open, the gel pulls apart and you cover your nose immediately. There is a red and large bag on the shelf, and the stench coming from it was putrid. Old, moldy food? Whatever it is, it is not pleasant.

You open Refrigerator, revealing Large bag.

>look at fridge
It's a plain white refrigerator with red and brown splashes all over it. You have no idea what it is, but you don't want to catch something, do you?

In Refrigerator is Large bag.

>look at bag
You see nothing special about Large bag.

* * *

Test Project Alpha v.1.0
An Interactive Fiction by Yim
Release 1 / Serial number 171116 / Inform 7 build 6M62 (I6/v6.33 lib 6/12N) SD

Center
Your vision blurred as you came to. Your memory is hazy and you can't remember the last time you were awake. You look around and find yourself in what looks like a beat-down motel room.

As you sit up, you can't help but notice that you were lying on a disgusting rug.

You notice a tape recorder next to you. Odd. Maybe you should switch it on and find out if there's anything useful on it?

>go northwest
Kitchen
The Kitchen reeks of something putrid. You cannot make out what the smell is or where it is coming from.

You struggle to open the fridge, but it's being held together by a thick red and brown gel. The gel resembles blood, but you can't be sure. You also take a whiff of an odor leaking from the small opening and it...is...horrible. Rotten food, maybe?

You can also see Sink, Countertop, Stove, Oven (closed) and Kitchen cabinets (closed) here.

>look at fridge
It's a plain white refrigerator with red and brown splashes all over it. You have no idea what it is, but you don't want to catch something, do you?

>open fridge
You struggle to open the fridge door due to a gel-like substance outlining its edges. As you slowly pull the door open, the gel pulls apart and you cover your nose immediately. There is a large red and brown bag on the shelf, and the stench coming from it was putrid. Old, moldy food? Whatever it is, it is not pleasant.

You open Refrigerator, revealing Large bag.

>look in fridge
In Refrigerator is Large bag.

>look at large bag
You see nothing special about Large bag.

>open large bag
You open Large bag, revealing Body parts.

>Take body parts
Taken.

* * *

>open fridge
You struggle to open the fridge door due to a gel-like substance outlining its edges. As you slowly pull the door open, the gel pulls apart and you cover your nose immediately. There is a large red and brown bag on the shelf, and the stench coming from it was putrid. Old, moldy food? Whatever it is, it is not pleasant.

You open Refrigerator, revealing Large bag.

>look at large bag
You see nothing special about Large bag.

>open large bag
It isn't something you can open.

>open bag
It isn't something you can open.

* * *

>open fridge
You struggle to open the fridge door due to a gel-like substance outlining its edges. As you slowly pull the door open, the gel pulls apart and you cover your nose immediately. There is a large red and brown bag on the shelf, and the stench coming from it was putrid. Old, moldy food? Whatever it is, it is not pleasant.

You open Refrigerator, revealing Large bag.

>look at bag
It is a red and brown bag. You can't see what's inside it, but there's a horrid odor coming from it. How long did it have to be in here for it to get that rotten? It also looks like there are large ox tails in it.

>look at fridge
It's a plain white refrigerator with red and brown splashes all over it. You have no idea what it is, but you don't want to catch something, do you?

In Refrigerator is Large bag.

* * *

>look at bag
It is a red and brown bag. You can't see what's inside it, but there's a horrid odor coming from it. How long did it have to be in here for it to get that rotten? It also looks like there are large ox tails in it.

>open bag
NOPE! Holy shit! There is an arm and a leg in the bag! Holy shit! Holy shit! The inside of the bag is also covered in chunky brown blobs of blood! What the actual hell?!

You open Large bag, revealing Dismembered arm and Dismembered leg.

>take all
Sink: Taken.
Stove: Taken.
Oven: Taken.
Kitchen cabinets: Taken.
Refrigerator: Taken.
Large bag: Taken.
Dismembered arm: Taken.
Dismembered leg: Taken.

* * *

>open fridge
You struggle to open the fridge door due to a gel-like substance outlining its edges. As you slowly pull the door open, the gel pulls apart and you cover your nose immediately. There is a large red and brown bag on the shelf, and the stench coming from it was putrid. Old, moldy food? Whatever it is, it is not pleasant.

You open Refrigerator, revealing Large bag.

>open bag
NOPE! Holy shit! There is an arm and a leg in the bag! Holy shit! Holy shit! The inside of the bag is also covered in chunky brown blobs of blood! What the actual hell?!

You open Large bag, revealing Dismembered arm and Dismembered leg.

* * *

>go northwest
Kitchen
The Kitchen reeks of something putrid. You cannot make out what the smell is or where it is coming from.

You struggle to open the fridge, but it's being held together by a thick red and brown gel. The gel resembles blood, but you can't be sure. You also take a whiff of an odor leaking from the small opening and it...is...horrible. Rotten food, maybe?

You can also see Sink, Countertop, Stove, Oven (closed) and Kitchen cabinets (closed) here.

>open fridge
You struggle to open the fridge door due to a gel-like substance outlining its edges. As you slowly pull the door open, the gel pulls apart and you cover your nose immediately. There is a large red and brown bag on the shelf, and the stench coming from it was putrid. Old, moldy food? Whatever it is, it is not pleasant.

You open Refrigerator, revealing Large bag.

* * *

>open bag
NOPE! Holy shit! There is an arm and a leg in the bag! Holy shit! Holy shit! The inside of the bag is also covered in chunky brown blobs of blood! What the actual hell?!

You open Large bag, revealing Dismembered arm and Dismembered leg.

>take all
Large bag: Taken.
Dismembered arm: It looks like it has been sliced off. The cut is also pretty clean...

It looks like it has been sliced off. Other than the clean cut, it was pretty muscular...

Taken.
Dismembered leg: Taken.

>take leg
You already have that.

>look at oven
It's a broken oven. What else do you want to know?

>open oven
HOLY SHIT THERE IS A DECAPITATED HEAD IN HERE! HOLY ****** SHIT! WHAT THE HELL IS GOING ON HERE?!

You open Oven, revealing Decapitated head.

>take head
It's a hairless head of a...well the skin is so burnt you can't even make out who it possibly could've been.

Taken.

>look at head
There's a note attached to one of the head's tooth. It reads, "For the purpose of this demonstration, present this and two other keys to the exit. Only then can you escape.

>go east
Exit
The Exit...is it the way out?

You can see a metal slab here.

>use head
You present the decapitated head to the door.

>open metal slab
You open the metal slab.

>go north
Freedom
You can see a metal slab here.

* * *

>go northwest
Kitchen
The Kitchen reeks of something putrid. You cannot make out what the smell is or where it is coming from.

You struggle to open the fridge, but it's being held together by a thick red and brown gel. The gel resembles blood, but you can't be sure. You also take a whiff of an odor leaking from the small opening and it...is...horrible. Rotten food, maybe?

You can also see Sink, Countertop, Stove, Oven (closed) and Kitchen cabinets (closed) here.

>look at refrigerator
It's a plain white refrigerator with red and brown splashes all over it. You have no idea what it is, but you don't want to catch something, do you?

>open refrigerator
You open Refrigerator, revealing Large bag.

* * *

>look at refrigerator
It's a plain white refrigerator with red and brown splashes all over it. You have no idea what it is, but you don't want to catch something, do you?

>open fridge
You open Refrigerator, revealing Large bag.

>look at fridge
It's a plain white refrigerator with red and brown splashes all over it. You have no idea what it is, but you don't want to catch something, do you?You struggle to open the fridge door due to a gel-like substance outlining its edges. As you slowly pull the door open, the gel pulls apart and you cover your nose immediately. There is a red and large bag on the shelf, and the stench coming from it was putrid. Old, moldy food? Whatever it is, it is not pleasant.

In Refrigerator is Large bag.

* * *

>go northwest
Kitchen
The Kitchen reeks of something putrid. You cannot make out what the smell is or where it is coming from.

You struggle to open the fridge, but it's being held together by a thick red and brown gel. The gel resembles blood, but you can't be sure. You also take a whiff of an odor leaking from the small opening and it...is...horrible. Rotten food, maybe?

You can also see Sink, Countertop, Stove, Oven (closed) and Kitchen cabinets (closed) here.

>look at fride
You can't see any such thing.

>look at fridge
It's a plain white refrigerator with red and brown splashes all over it. You have no idea what it is, but you don't want to catch something, do you?

>open fridge
You open Refrigerator, revealing Large bag.

>look at fridge
You struggle to open the fridge door due to a gel-like substance outlining its edges. As you slowly pull the door open, the gel pulls apart and you cover your nose immediately. There is a red and large bag on the shelf, and the stench coming from it was putrid. Old, moldy food? Whatever it is, it is not pleasant.

In Refrigerator is Large bag.

* * *

>go northwest
Kitchen
The Kitchen reeks of something putrid. You cannot make out what the smell is or where it is coming from.

You struggle to open the fridge, but it's being held together by a thick red and brown gel. The gel resembles blood, but you can't be sure. You also take a whiff of an odor leaking from the small opening and it...is...horrible. Rotten food, maybe?

You can also see Sink, Countertop, Stove, Oven (closed) and Kitchen cabinets (closed) here.

>look at refrigeration
It's a plain white refrigerator with red and brown splashes all over it. You have no idea what it is, but you don't want to catch something, do you?

>open fridge
You struggle to open the fridge door due to a gel-like substance outlining its edges. As you slowly pull the door open, the gel pulls apart and you cover your nose immediately. There is a red and large bag on the shelf, and the stench coming from it was putrid. Old, moldy food? Whatever it is, it is not pleasant.

You open Refrigerator, revealing Large bag.

* * *

>go northwest
Kitchen
The Kitchen reeks of something putrid. You cannot make out what the smell is or where it is coming from.

You struggle to open the fridge, but it's being held together by a thick red and brown gel. The gel resembles blood, but you can't be sure. You also take a whiff of an odor leaking from the small opening and it...is...horrible. Rotten food, maybe?

You can also see Sink, Countertop, Stove, Oven (closed) and Kitchen cabinets (closed) here.

>lok at fridge
That's not a verb I recognise.

>look at fridge
It's a plain white refrigerator with red and brown splashes all over it. You have no idea what it is, but you don't want to catch something, do you?

* * *

>open fridge
You struggle to open the fridge door due to a gel-like substance outlining its edges. As you slowly pull the door open, the gel pulls apart and you cover your nose immediately. There is a red and large bag on the shelf, and the stench coming from it was putrid. Old, moldy food? Whatever it is, it is not pleasant.

You open Refrigerator, revealing Large bag.

>look at large bag
It is a red and brown bag. You can't see what's inside it, but there's a horrid odor coming from it. How long did it have to be in here for it to get that rotten?

>open large bag
Holy shit! There is an arm and a leg here! Holy shit! Holy shit! The inside of the bag is also covered in chunky brown blobs of blood! What the actual hell?!

You struggle to open the fridge door due to a gel-like substance outlining its edges. As you slowly pull the door open, the gel pulls apart and you cover your nose immediately. There is a red and large bag on the shelf, and the stench coming from it was putrid. Old, moldy food? Whatever it is, it is not pleasant.

You open Large bag, revealing Dismembered arm and Dismembered leg.

>open large bag
That's already open.

>close large bag
You close Large bag.

>open large bag
Holy shit! There is an arm and a leg here! Holy shit! Holy shit! The inside of the bag is also covered in chunky brown blobs of blood! What the actual hell?!

You struggle to open the fridge door due to a gel-like substance outlining its edges. As you slowly pull the door open, the gel pulls apart and you cover your nose immediately. There is a red and large bag on the shelf, and the stench coming from it was putrid. Old, moldy food? Whatever it is, it is not pleasant.

You open Large bag, revealing Dismembered arm and Dismembered leg.

* * *

>go northwest
Kitchen
The Kitchen reeks of something putrid. You cannot make out what the smell is or where it is coming from.

You struggle to open the fridge, but it's being held together by a thick red and brown gel. The gel resembles blood, but you can't be sure. You also take a whiff of an odor leaking from the small opening and it...is...horrible. Rotten food, maybe?

You can also see Sink, Countertop, Stove, Oven (closed) and Kitchen cabinets (closed) here.

>open refrigerator
You struggle to open the fridge door due to a gel-like substance outlining its edges. As you slowly pull the door open, the gel pulls apart and you cover your nose immediately. There is a red and large bag on the shelf, and the stench coming from it was putrid. Old, moldy food? Whatever it is, it is not pleasant.

You open Refrigerator, revealing Large bag.

>open bag
NOPE! Holy shit! There is an arm and a leg in the bag! Holy shit! Holy shit! The inside of the bag is also covered in chunky brown blobs of blood! What the actual hell?!

You open Large bag, revealing Dismembered arm and Dismembered leg.

* * *

>go northwest
Kitchen
The Kitchen reeks of something putrid. You cannot make out what the smell is or where it is coming from.

You struggle to open the fridge, but it's being held together by a thick red and brown gel. The gel resembles blood, but you can't be sure. You also take a whiff of an odor leaking from the small opening and it...is...horrible. Rotten food, maybe?

You can also see Sink, Countertop, Stove, Oven (closed) and Kitchen cabinets (closed) here.

>take all
There are none at all available!

>take sink
That's fixed in place.

>open fridge
You struggle to open the fridge door due to a gel-like substance outlining its edges. As you slowly pull the door open, the gel pulls apart and you cover your nose immediately. There is a large red and brown bag on the shelf, and the stench coming from it was putrid. Old, moldy food? Whatever it is, it is not pleasant.

You open Refrigerator, revealing Large bag.

* * *

>open bag
NOPE! Holy shit! There is an arm and a leg in the bag! Holy shit! Holy shit! The inside of the bag is also covered in chunky brown blobs of blood! What the actual hell?!

You open Large bag, revealing Dismembered arm and Dismembered leg.

>take all
Large bag: Taken.
Dismembered arm: Taken.
Dismembered leg: Taken.

>inventory
You are carrying:
  Dismembered leg
  Dismembered arm
  Large bag (open but empty)

>exit kitchen
I only understood you as far as wanting to exit.

>exit kitchen to center
I only understood you as far as wanting to exit.

* * *

>go northwest
Kitchen
The Kitchen reeks of something putrid. You cannot make out what the smell is or where it is coming from.

You struggle to open the fridge, but it's being held together by a thick red and brown gel. The gel resembles blood, but you can't be sure. You also take a whiff of an odor leaking from the small opening and it...is...horrible. Rotten food, maybe?

You can also see Sink, Countertop, Stove, Oven (closed) and Kitchen cabinets (closed) here.

>look at oven
It's a broken oven. What else do you want to know?

* * *

>open oven
HOLY SHIT THERE IS A DECAPITATED HEAD IN HERE! HOLY ****** SHIT! WHAT THE HELL IS GOING ON HERE?!

You open Oven, revealing Decapitated head.

>look at decapitated head
It's a hairless head of a...well the skin is so burnt you can't even make out who it possibly could've been.

>take head
Taken.

* * *

>look at oven
It's a broken oven. What else do you want to know?

>take oven
That's fixed in place.

>open oven
HOLY SHIT THERE IS A DECAPITATED HEAD IN HERE! HOLY ****** SHIT! WHAT THE HELL IS GOING ON HERE?!

You open Oven, revealing Decapitated head.

>take head
Taken.

>look at head
It's a hairless head of a...well the skin is so burnt you can't even make out who it possibly could've been.

* * *

>go northwest
Kitchen
The Kitchen reeks of something putrid. You cannot make out what the smell is or where it is coming from.

You struggle to open the fridge, but it's being held together by a thick red and brown gel. The gel resembles blood, but you can't be sure. You also take a whiff of an odor leaking from the small opening and it...is...horrible. Rotten food, maybe?

You can also see Sink, Countertop, Stove, Oven (closed) and Kitchen cabinets (closed) here.

>look at sink
There's a butter knife in the sink.

>look at butter knife
You can't see any such thing.

* * *

>look at sink
There's a butter knife in the sink.

>take butter knife
Taken.

>look at fridge
It's a plain white refrigerator with red and brown splashes all over it. You have no idea what it is, but you don't want to catch something, do you?

* * *

>take all
Large bag: Taken.
Dismembered arm: Taken.
Dismembered leg: Taken.

>look at sink
There's a butter knife in the sink.

>take knife
Taken.

>inventory
You are carrying:
  Butter knife
  Dismembered leg
  Dismembered arm
  Large bag (open but empty)

>look at sink
There's a butter knife in the sink.

* * *

>take knife
Taken.

>take knife
You already have that.

>inventory
You are carrying:
  Butter knife
  Dismembered leg
  Dismembered arm
  Large bag (open but empty)

* * *

>take butter knife
Taken.

>go southeast
Center
Your vision blurred as you came to. Your memory is hazy and you can't remember the last time you were awake. You look around and find yourself in what looks like a beat-down motel room.

As you sit up, you can't help but notice that you were lying on a disgusting rug.

You notice a tape recorder next to you. Odd. Maybe you should switch it on and find out if there's anything useful on it?

>take rug
What the...there's a bent floorboard here. I wonder if I can lift it?

Taken.

>look at bent floorboard
It looks like the floorboard was removed once before, and there's a gap big enough to store a tool or something. How can I get down there?

>use butter knife
You cannot use the butter knife here.

>open bent floorboard
It isn't something you can open.

* * *

>use butter knife
You cannot use the butter knife here.

>use butter knife on bent floorboard
I only understood you as far as wanting to use Butter knife.

>open bent floorboard
It isn't something you can open.

* * *

>take rug
What the...there's a bent floorboard here. I wonder if I can lift it?

Taken.

>look at floorboard
It looks like the floorboard was removed once before, and there's a gap big enough to store a tool or something. How can I get down there?

* * *

>take rug
What the...there's a bent floorboard here. I wonder if I can lift it?

Taken.

>look at floorboad
You can't see any such thing.

>look at floorboard
It looks like the floorboard was removed once before, and there's a gap big enough to store a tool or something. How can I get down there?

>use butter knife
You place the end of the butter knife underneath the floorboard and pushed down on the opposite end. The floorboard bends upwards and soon enough, it pries open.

* * *

>take rug
What the...there's a bent floorboard here. I wonder if I can lift it?

Taken.

>use knife
You place the end of the butter knife underneath the floorboard and pushed down on the opposite end. The floorboard bends upwards and soon enough, it pries open. Hidden under the shadows is what looks like a meat cleaver.

>take cleaver
You can't see any such thing.

* * *

>take knife
Taken.

>go southeast
Center
Your vision blurred as you came to. Your memory is hazy and you can't remember the last time you were awake. You look around and find yourself in what looks like a beat-down motel room.

As you sit up, you can't help but notice that you were lying on a disgusting rug.

You notice a tape recorder next to you. Odd. Maybe you should switch it on and find out if there's anything useful on it?

* * *

>look at floorboard
It looks like the floorboard was removed once before, and there's a gap big enough to store a tool or something. How can I get down there?

>use knife
You place the end of the butter knife underneath the floorboard and pushed down on the opposite end. The floorboard bends upwards and soon enough, it pries open. Hidden under the shadows is what looks like a meat cleaver.

* * *

>take cleaver
You can't see any such thing.

>look at cleaver
You can't see any such thing.

>open floorboard
You open Bent floorboard, revealing Cleaver.

>look at cleaver
It's pretty dark down there so you can't really make out the cleaver.

>take cleaver
It looks like it's in good condition, but you couldn't help but notice that there's a bit of dried blood on its edge... Don't think about it.

Taken.

>go west
Living Area
The Living Area does not look too fancy. Everything looks old and dirty. I mean...what else are you looking for.

>look at box tv
You can't see any such thing.

>look at box TV
You can't see any such thing.

* * *

>take cleaver
You can't see any such thing.

>open floorboard
You open Bent floorboard, revealing Cleaver.

>take cleaver
It looks like it's in good condition, but you couldn't help but notice that there's a bit of dried blood on its edge... Don't think about it.

Taken.

>go northwest
Kitchen
The Kitchen reeks of something putrid. You cannot make out what the smell is or where it is coming from.

You can see Refrigerator (closed), Sink, Countertop, Stove, Oven (closed) and Kitchen cabinets (closed) here.

>open oven
There is a large red and brown bag on the shelf, and the stench coming from it was putrid. Old, moldy food? Whatever it is, it is not pleasant.

You open Oven, revealing Large bag.

>take bag
Taken.

>open bag
NOPE! Holy shit! There is an arm and a leg in the bag! Holy shit! Holy shit! The inside of the bag is also covered in chunky brown blobs of blood! What the actual hell?!

You open Large bag, revealing Dismembered arm and Dismembered leg.

>take all
There are none at all available!

>take arm
It looks like it has been sliced off. The cut is also pretty clean...

Taken.

>take leg
It looks like it has been sliced off. Other than the clean cut, it was pretty muscular...

Taken.

>open fridge
It seems to be locked.

>use cleaver
You saw through the enigmatic gel with the cleaver, blood dripping everywhere, but at least you got it open. The smell is even stronger now, so you cover your nose as you look further into the fridge.

>open fridge
HOLY SHIT THERE IS A DECAPITATED HEAD IN HERE! HOLY ****** SHIT! WHAT THE HELL IS GOING ON HERE?!

You open Refrigerator, revealing Decapitated head.

>look at head
There's a note attached to one of the head's tooth. It reads, "For the purpose of this demonstration, present this and two other keys to the exit. Only then can you escape."

>take head
It's a hairless head of a...well the skin is so burnt you can't even make out who it possibly could've been.

Taken.

>go east
Exit
The Exit...is it the way out?

You can see a metal slab here.

* * *

>use head
You present the decapitated head to the door.

>open door
You can't see any such thing.

>open slab
You open the metal slab.

>go north
Freedom
Congratulations! You've gotten out...for now. But you'll be back.

You can see a metal slab here.

* * *

>go northwest
Kitchen
The Kitchen reeks of something putrid. You cannot make out what the smell is or where it is coming from.

You struggle to open the fridge, but it's being held together by a thick red and brown gel. The gel resembles blood, but you can't be sure. You also take a whiff of an odor leaking from the small opening and it...is...horrible. Rotten food, maybe?

You can also see Sink, Countertop, Stove, Oven (closed) and Kitchen cabinets (closed) here.

>lok at sink
That's not a verb I recognise.

>look at sink
The sink may be incapable of running water, but there's a butter knife in it.

>take butter knife
That's hardly portable.

* * *

>go northwest
Kitchen
The Kitchen reeks of something putrid. You cannot make out what the smell is or where it is coming from.

You struggle to open the fridge, but it's being held together by a thick red and brown gel. The gel resembles blood, but you can't be sure. You also take a whiff of an odor leaking from the small opening and it...is...horrible. Rotten food, maybe?

You can also see Sink, Countertop, Stove, Oven (closed) and Kitchen cabinets (closed) here.

>take butter knife
You can't see any such thing.

>look at sink
There's a butter knife in the sink.

* * *

>look at floorboard
It looks like the floorboard was removed once before, and there's a gap big enough to store a tool or something. How can I get down there?

>use butter knife
You place the end of the butter knife underneath the floorboard and pushed down on the opposite end. The floorboard bends upwards and soon enough, it pries open. Hidden under the shadows is what looks like a meat cleaver.

>take cleaver
You can't see any such thing.

* * *

>go northwest
Kitchen
The Kitchen reeks of something putrid. You cannot make out what the smell is or where it is coming from.

You struggle to open the fridge, but it's being held together by a thick red and brown gel. The gel resembles blood, but you can't be sure. You also take a whiff of an odor leaking from the small opening and it...is...horrible. Rotten food, maybe?

You can also see Sink, Countertop, Stove, Oven (closed) and Kitchen cabinets (closed) here.

>open oven
There is a large red and brown bag on the shelf, and the stench coming from it was putrid. Old, moldy food? Whatever it is, it is not pleasant.

You open Oven, revealing Large bag.

>look at head
There's a note attached to one of the head's tooth. It reads, "For the purpose of this demonstration, present this and two other keys to the exit. Only then can you escape.

>take head
It's a hairless head of a...well the skin is so burnt you can't even make out who it possibly could've been.

Taken.

>go east
Exit
The Exit...is it the way out?

>look at door
You can't see any such thing.

* * *

>take all
There are none at all available!

>take arm
It looks like it has been sliced off. The cut is also pretty clean...

It looks like it has been sliced off. Other than the clean cut, it was pretty muscular...

Taken.

>open fridge
It seems to be locked.

* * *

Test Project Alpha v.1.0
An Interactive Fiction by Yim
Release 1 / Serial number 171116 / Inform 7 build 6M62 (I6/v6.33 lib 6/12N) SD

Center
Your vision blurred as you came to. Your memory is hazy and you can't remember the last time you were awake. You look around and find yourself in what looks like a beat-down motel room.

As you sit up, you can't help but notice that you were lying on a disgusting rug.

You notice a tape recorder next to you. Odd. Maybe you should switch it on and find out if there's anything useful on it?

>look at tape recorder
The tape recorder is currently switched off.

>switch on tape recorder
You can't quite make out who is speaking, but the voice is heavily altered and ominous, "You have been selected to play this game. Do not worry, you are not in any mortal dangers...yet. Your goal is to escape this room. Relax, there is no timer, so feel free to take your time. However, do be careful. Committing certain actions without thinking about the consequences can be...dangerous."

You switch the tape recorder on.

>switch off tape recorder
You switch the tape recorder off.

* * *

Test Project Alpha v.1.0
An Interactive Fiction by Yim
Release 1 / Serial number 171116 / Inform 7 build 6M62 (I6/v6.33 lib 6/12N) SD

Center
Your vision blurred as you came to. Your memory is hazy and you can't remember the last time you were awake. You look around and find yourself in what looks like a beat-down motel room.

As you sit up, you can't help but notice that you were lying on a disgusting rug.

You notice a tape recorder next to you. Odd. Maybe you should switch it on and find out if there's anything useful on it?

>Take tape recorder
Taken.

>switch on tape recorder
The tape plays and a heavily altered and ominous voice plays. "Hey, so you're not supposed to hear this, but you've been covertly selected to play this so-called "game" created by my father. I know, I know. It's pretty fucked up, you know, without your consent and whatnot. My dad is a...strange, maniacal man. He likes to toy with his prey before he kills them. Speaking of which, you need to get out of there as fast as you can. If you don't, you'll either be stuck there or die. Look around the room, search for clues, do anything necessary to leave this place! However, be careful with what you do. Committing certain actions without thinking about the consequences may jeopardize your chance of beating this game. Good luck." The tape ends.

You switch the tape recorder on.

* * *

Test Project Alpha v.1.0
An Interactive Fiction by Yim
Release 1 / Serial number 171116 / Inform 7 build 6M62 (I6/v6.33 lib 6/12N) SD

Center
Your vision blurred as you came to. Your memory is hazy and you can't remember the last time you were awake. You look around and find yourself in what looks like a beat-down motel room.

As you sit up, you can't help but notice that you were lying on a disgusting rug.

You notice a tape recorder next to you. Odd. Maybe you should switch it on and find out if there's anything useful on it?

>look around center
You can't see any such thing.

>look at center
You can't see any such thing.

>go to center
You can't see any such thing.

>stay put
That's not a verb I recognise.

>stay
That's not a verb I recognise.

>look north
You see nothing unexpected in that direction.

* * *

Test Project Alpha v.1.0
An Interactive Fiction by Yim
Release 1 / Serial number 171116 / Inform 7 build 6M62 (I6/v6.33 lib 6/12N) SD

Center
Your vision blurred as you came to. Your memory is hazy and you can't remember the last time you were awake. You look around and find yourself in what looks like a beat-down motel room.

As you sit up, you can't help but notice that you were lying on a disgusting rug.

You notice a tape recorder next to you. Odd. Maybe you should switch it on and find out if there's anything useful on it?

>examine center
You can't see any such thing.

>examine room
You can't see any such thing.

>examine center
You can't see any such thing.

>examine the center
You can't see any such thing.

>examine around
You can't see any such thing.

>look around
You can't see any such thing.

>look at center
You can't see any such thing.

>look around center
You can't see any such thing.

>look around room
You can't see any such thing.

>examine room
You can't see any such thing.

* * *

>examine center
You can't see any such thing.

>go to kitchen
You can't see any such thing.

* * *

Test Project Alpha v.1.0
An Interactive Fiction by Yim
Release 1 / Serial number 171116 / Inform 7 build 6M62 (I6/v6.33 lib 6/12N) SD

Center
Your vision blurred as you came to. Your memory is hazy and you can't remember the last time you were awake. You look around and find yourself in what looks like a beat-down motel room.

As you sit up, you can't help but notice that you were lying on a disgusting rug.

You notice a tape recorder next to you. Odd. Maybe you should switch it on and find out if there's anything useful on it?

>go to kitchen
You can't see any such thing.

>go northwest
Kitchen
The Kitchen reeks of something putrid. You cannot make out what the smell is or where it is coming from.

You can see Sink, Countertop, Stove, Oven, Kitchen cabinets (closed) and Refrigerator (closed) here.

* * *

>look at fridge
It's a plain white refrigerator with red and brown splashes all over it. You have no idea what it is, but you don't want to catch something, do you?

>open fridge
You struggle to open the fridge door due to a gel-like substance outlining its edges. As you slowly pull the door open, the gel pulls apart and you cover your nose immediately. There is a red and large bag on the shelf, and the stench coming from it was putrid. Old, moldy food? Whatever it is, it is not pleasant.

Holy shit. There is an arm and a leg here. Holy shit. Holy shit. The inside of the bag is also covered in chunky brown blobs of blood. What the actual hell?!

You open Refrigerator, revealing Large bag.

* * *

Test Project Alpha v.1.0
An Interactive Fiction by Yim
Release 1 / Serial number 171116 / Inform 7 build 6M62 (I6/v6.33 lib 6/12N) SD

Center
Your vision blurred as you came to. Your memory is hazy and you can't remember the last time you were awake. You look around and find yourself in what looks like a beat-down motel room.

As you sit up, you can't help but notice that you were lying on a disgusting rug.

You notice a tape recorder next to you. Odd. Maybe you should switch it on and find out if there's anything useful on it?

>go east
Rest Area
The Rest Area no longer suits its purpose. There is a bed with torn sheets and no blanket, a cracked wooden desk with no chair, and a dusty closet.

>go east
Closet
It's a regular closet, but there aren't any clothes. Just...nothing but dust. Yeah. That's it. It's a closet.

* * *

Test Project Alpha v.1.0
An Interactive Fiction by Yim
Release 1 / Serial number 171116 / Inform 7 build 6M62 (I6/v6.33 lib 6/12N) SD

Center
Your vision blurred as you came to. Your memory is hazy and you can't remember the last time you were awake. You look around and find yourself in what looks like a beat-down motel room.

As you sit up, you can't help but notice that you were lying on a disgusting rug.

You notice a tape recorder next to you. Odd. Maybe you should switch it on and find out if there's anything useful on it?

>take rug
What the...there's a bent floorboard here. I wonder if I can lift it?

Taken.

>inventory
You are carrying:
  a rug

>open floorboard
You can't see any such thing.

>open bent floorboard
You can't see any such thing.

* * *

>take rug
What the...there's a bent floorboard here. I wonder if I can lift it?

Taken.

>open bent floorboard
You can't see any such thing.

* * *

>take rug
What the...there's a bent floorboard here. I wonder if I can lift it?

Taken.

>take bent floorboard
You can't see any such thing.

>look at bent floorboard
You can't see any such thing.

* * *

Test Project Alpha v.1.0
An Interactive Fiction by Yim
Release 1 / Serial number 171116 / Inform 7 build 6M62 (I6/v6.33 lib 6/12N) SD

Center
Your vision blurred as you came to. Your memory is hazy and you can't remember the last time you were awake. You look around and find yourself in what looks like a beat-down motel room.

As you sit up, you can't help but notice that you were lying on a disgusting rug.

You notice a tape recorder next to you. Odd. Maybe you should switch it on and find out if there's anything useful on it?

>take a rug
What the...there's a bent floorboard here. I wonder if I can lift it?

Taken.

>open bent floorboard
It isn't something you can open.

>go northwest
Kitchen
The Kitchen reeks of something putrid. You cannot make out what the smell is or where it is coming from.

You can see Sink, Countertop, Stove, Oven (closed), Kitchen cabinets (closed) and Refrigerator (closed) here.

>look at sink
There's a butter knife in the sink.

* * *

>take butter knife
Taken.

>go southeast
Center
Your vision blurred as you came to. Your memory is hazy and you can't remember the last time you were awake. You look around and find yourself in what looks like a beat-down motel room.

You notice a tape recorder next to you. Odd. Maybe you should switch it on and find out if there's anything useful on it?

* * *

Test Project Alpha v.1.0
An Interactive Fiction by Yim
Release 1 / Serial number 171116 / Inform 7 build 6M62 (I6/v6.33 lib 6/12N) SD

Center
Your vision blurred as you came to. Your memory is hazy and you can't remember the last time you were awake. You look around and find yourself in what looks like a beat-down motel room.

As you sit up, you can't help but notice that you were lying on a disgusting rug.

You notice a tape recorder next to you. Odd. Maybe you should switch it on and find out if there's anything useful on it?

>go west
Living Area
The Living Area does not look too fancy. Everything looks old and dirty. I mean...what else are you looking for.

You can see Box TV here.

>look at box tv
It's an old box TV with antennaes. It has been a long time since you've seen one of those. Then again, everything in this room is pretty ancient. You press the power button, but it doesn't seem to work. No electricity maybe?

Box TV is currently switched off.

* * *

>go west
Living Area
The Living Area does not look too fancy. Everything looks old and dirty. I mean...what else are you looking for.

You can see Box TV here.

>see box tv
That's not a verb I recognise.

>look at box tv
It's an old box TV with antennaes. It has been a long time since you've seen one of those. Then again, everything in this room is pretty ancient. You press the power button, but it doesn't seem to work. You check the plug and it's plugged in. No electricity, maybe?

>go east
Center
Your vision blurred as you came to. Your memory is hazy and you can't remember the last time you were awake. You look around and find yourself in what looks like a beat-down motel room.

As you sit up, you can't help but notice that you were lying on a disgusting rug.

You notice a tape recorder next to you. Odd. Maybe you should switch it on and find out if there's anything useful on it?

>go south
Bathroom
The Bathroom is dirty and mold everywhere. There's a bathroom sink, a toilet, and a bathtub.

>look at sink
You can't see any such thing.

>look at bathroom sink
You can't see any such thing.

* * *

Test Project Alpha v.1.0
An Interactive Fiction by Yim
Release 1 / Serial number 171116 / Inform 7 build 6M62 (I6/v6.33 lib 6/12N) SD

Center
Your vision blurred as you came to. Your memory is hazy and you can't remember the last time you were awake. You look around and find yourself in what looks like a beat-down motel room.

As you sit up, you can't help but notice that you were lying on a disgusting rug.

You notice a tape recorder next to you. Odd. Maybe you should switch it on and find out if there's anything useful on it?

>go south
Bathroom
The Bathroom is dirty and mold everywhere.

You can see Dirty sink, Mirror, Toilet and Bathtub here.

>look at dirty sink
It completely covered in some disgusting red and brown substance. You don't want to know what it is.

Dirty sink is currently switched off.

>look at bathtub
You see nothing special about Bathtub.

>look at mirror
What are you looking at?